NB_LIGNES 10
NB_COLONNES 15
LIGNE 0:0:0:2:1:0:0:0:0:0:0:0:0:0:0
LIGNE 0:0:0:2:1:0:0:0:0:0:0:0:0:0:0
LIGNE 0:0:0:2:1:0:0:0:0:0:0:0:0:0:0
LIGNE 0:0:0:2:1:0:0:0:0:0:0:0:0:0:0
LIGNE 0:0:0:2:1:0:0:0:0:0:0:0:0:0:0
LIGNE 4:4:4:6:8:4:4:4:4:4:4:4:4:4:4
LIGNE 3:3:3:5:7:3:3:3:3:3:3:3:3:3:3
LIGNE 0:0:0:2:1:0:0:0:0:0:0:0:0:0:0
LIGNE 0:0:0:2:1:0:0:0:0:0:0:0:0:0:0
LIGNE 0:0:0:2:1:0:0:0:0:0:0:0:0:0:0

